@@@@@@@@
@      @
@ @ @@@@@@@
@ @     @ @
@2@@@@@ @ @
@@@   @   @
 @  @@@ @@@
@@     1@
 @@@@@@@